   0     1     2     3     4     5     6     7     8     9     10    11    12
0- ## 9  ## 9  ## 9  ## 9  ## 9  OO 1  ## 9  ## 9  ## 9  ## 9  ## 9  !! 0  ## 9
1- !! 1  __ 7  #_ 8  ## 9  WG 1  ** 0  __ 7  __ 7  ## 9  ## 9  ## 9  OO 0  #_ 8
2- #_ 8  __ 7  ** 1  __ 7  __ 7  #_ 8  __ 7  #_ 8  __ 7  __ 7  __ 7  ** 1  __ 7
3- OO 1  #_ 8  __ 7  #_ 8  __ 7  OO 1  JS 1  ** 1  __ 7  #_ 8  __ 7  __ 7  __ 7
4- __ 7  #_ 8  #_ 8  __ 7  __ 7  #_ 8  __ 7  #_ 8  JB 1  __ 7  __ 7  #_ 8  SG 1
5- JW 1  __ 7  __ 7  #_ 8  IL 1  ** 1  __ 7  OO 1  __ 7  #_ 8  #_ 8  #_ 8  OO 1
6- __ 7  ** 1  __ 7  __ 7  __ 7  #_ 8  SH 1  #_ 8  __ 7  __ 7  __ 7  __ 7  __ 7
7- __ 7  __ 7  OO 0  #_ 8  __ 7  __ 7  __ 7  ** 0  __ 7  #_ 8  ** 1  __ 7  ## 9
8- ## 9  !! 0  #_ 8  ## 9  ## 9  ## 9  __ 7  OO 1  MS 1  ## 9  ## 9  !! 1  ## 9